13 13
3 3 3 3 3 3 3 3 3 3 3 3 3
3 2 2 2 2 2 2 3 1 1 1 1 3
3 2 2 2 2 2 2 3 1 1 1 1 3
3 2 2 2 2 2 2 2 1 1 1 1 3
3 2 2 2 2 2 2 3 1 1 1 1 3
3 2 2 2 2 2 2 3 1 1 1 1 3
3 3 3 3 2 3 3 3 3 3 3 3 3
0 3 2 2 2 2 2 2 2 2 3 0 0
0 3 2 2 2 2 2 2 2 2 3 0 0
0 3 2 2 2 2 2 2 2 2 3 0 0
0 3 2 2 2 2 2 2 2 2 3 0 0
0 3 2 2 2 2 2 2 2 2 3 0 0
0 3 3 3 3 3 3 3 3 3 3 0 0
3
door 4 6
sink 10 1
stove 11 1
