17 13
0 0 0 0 3 3 3 3 3 3 3 3 3 3 3 3 3
0 0 0 0 3 2 2 2 2 2 2 3 1 1 1 1 3
0 0 0 0 3 2 2 2 2 2 2 3 1 1 1 1 3
3 3 3 3 3 2 2 2 2 2 2 2 1 1 1 1 3
3 1 1 1 3 2 2 2 2 2 2 3 1 1 1 1 3
3 1 1 1 3 2 2 2 2 2 2 3 1 1 1 1 3
3 1 1 1 3 2 3 3 2 3 3 3 2 3 3 3 3
3 1 1 1 2 2 3 2 2 2 2 2 2 2 3 0 0
3 3 3 3 3 3 3 2 2 2 2 2 2 2 3 0 0
0 0 0 0 0 0 3 2 2 2 2 2 2 2 3 0 0
0 0 0 0 0 0 3 2 2 2 2 2 2 2 3 0 0
0 0 0 0 0 0 3 2 2 2 2 2 2 2 3 0 0
0 0 0 0 0 0 3 3 3 3 3 3 3 3 3 0 0
7
door 4 7
door 8 6
door 12 6
door 11 3
sink 14 1
stove 15 1
sink 2 4
0
